Holding Bays,Closing Time,Total Arrivals,Processed,Reneged,Cancelled,Transferred
11,20,216,126,90,0,1
11,22,219,130,89,0,0
11,24,235,124,111,0,0
15,20,193,162,31,0,2
15,22,226,174,52,0,1
15,24,258,176,82,0,0
18,20,214,187,27,0,1
18,22,221,194,27,0,0
18,24,226,196,30,0,0
22,20,203,203,0,0,0
22,22,248,238,10,0,0
22,24,223,215,8,0,0
